1111111111111111111111111111111111
1E000000H000000C00000C0000000H0001
10100101001000001010010000H0010101
1010010010101010001001000000010101
1P0000000C00C000000H0000H0000000C1
1111111111111111111111111111111111